,index,주소,22시승차총승객수,22시하차총승객수,23시승차총승객수,23시하차총승객수,승차승객합,하차승객합,lat,lng
0,263,서울특별시 강남구 개포1동,758,2648,328,1164,1086,3812,37.4817688,127.0576308
1,264,서울특별시 강남구 개포2동,1461,6345,685,2756,2146,9101,37.4896011,127.0687685
2,265,서울특별시 강남구 개포4동,4007,8191,1511,4108,5518,12299,37.4788251,127.0515205
3,266,서울특별시 강남구 개포동,11997,17117,4494,7637,16491,24754,37.4789643,127.0609282
4,267,서울특별시 강남구 논현2동,351,459,157,264,508,723,37.5172921,127.0371878
5,268,서울특별시 강남구 논현동,30721,31450,16400,16468,47121,47918,37.5135304,127.0315341
6,269,서울특별시 강남구 대치1동,12897,3907,2785,2019,15682,5926,37.4932114,127.0567416
7,270,서울특별시 강남구 대치2동,10825,5520,2890,2617,13715,8137,37.5021274,127.0641296
8,271,서울특별시 강남구 대치동,74552,30740,20279,14583,94831,45323,37.4994914,127.0610527
9,272,서울특별시 강남구 도곡1동,4397,6582,1897,3089,6294,9671,37.4908234,127.0382995
10,273,서울특별시 강남구 도곡2동,6191,6739,3444,3911,9635,10650,37.4824625,127.0430492
11,274,서울특별시 강남구 도곡동,13292,11165,5771,3804,19063,14969,37.4898434,127.0438136
12,275,서울특별시 강남구 삼성1동,487,439,101,267,588,706,37.5117931,127.0553802
13,276,서울특별시 강남구 삼성동,44096,31496,20416,14081,64512,45577,37.5139848,127.0565207
14,277,서울특별시 강남구 세곡동,7617,25789,3148,14462,10765,40251,37.46927120000001,127.1073203
15,278,서울특별시 강남구 수서동,25214,8108,14168,3343,39382,11451,37.4889628,127.105154
16,279,서울특별시 강남구 신사동,33466,19686,17444,11197,50910,30883,37.524124,127.022883
17,280,서울특별시 강남구 압구정동,17142,9837,9414,5445,26556,15282,37.531684,127.0302926
18,281,서울특별시 강남구 역삼1동,251,611,170,333,421,944,37.4952107,127.0331888
19,282,서울특별시 강남구 역삼2동,8459,5796,2480,2279,10939,8075,37.4959889,127.0467425
20,283,서울특별시 강남구 역삼동,107366,64621,60182,33869,167548,98490,37.4999072,127.0373932
21,284,서울특별시 강남구 율현동,267,1245,97,625,364,1870,37.4720063,127.1104558
22,285,서울특별시 강남구 일원1동,1822,4429,1348,2031,3170,6460,37.49179609999999,127.0879606
23,286,서울특별시 강남구 일원2동,1020,642,575,360,1595,1002,37.4921008,127.073629
24,287,서울특별시 강남구 일원동,5393,14498,2781,5890,8174,20388,37.4810133,127.0801089
25,288,서울특별시 강남구 일원본동,2157,4947,1528,1975,3685,6922,37.4833521,127.086378
26,289,서울특별시 강남구 자곡동,611,315,245,178,856,493,37.474172,127.0950243
27,290,서울특별시 강남구 청담동,20552,17300,9650,9265,30202,26565,37.5231998,127.0486655
28,291,서울특별시 강동구 강일동,5488,17938,2557,11267,8045,29205,37.5626796,127.1742333
29,292,서울특별시 강동구 고덕1동,1441,2406,586,1490,2027,3896,37.558983,127.1489257
30,293,서울특별시 강동구 고덕2동,2535,2698,1053,1456,3588,4154,37.5604551,127.1643122
31,294,서울특별시 강동구 고덕동,1901,3243,757,1770,2658,5013,37.5632814,127.1570594
32,295,서울특별시 강동구 길동,4073,7405,2059,4129,6132,11534,37.5392074,127.1461206
33,296,서울특별시 강동구 둔촌1동,2309,2326,1181,1274,3490,3600,37.5234321,127.1366779
34,297,서울특별시 강동구 둔촌2동,8764,4133,4656,2046,13420,6179,37.53332,127.1419272
35,298,서울특별시 강동구 둔촌동,817,1715,285,927,1102,2642,37.5272032,127.144105
36,299,서울특별시 강동구 명일1동,1175,1980,372,1171,1547,3151,37.54973409999999,127.1459813
37,300,서울특별시 강동구 명일2동,5881,1058,1119,484,7000,1542,37.5463186,127.1512869
38,301,서울특별시 강동구 명일동,9430,8976,4559,4853,13989,13829,37.5502209,127.1500409
39,302,서울특별시 강동구 상일동,12701,15210,6035,9120,18736,24330,37.55110639999999,127.1646653
40,303,서울특별시 강동구 성내1동,171,229,75,148,246,377,37.530375,127.1223451
41,304,서울특별시 강동구 성내2동,8758,8270,5519,5009,14277,13279,37.5323199,127.1294284
42,305,서울특별시 강동구 성내3동,5023,5484,2231,2949,7254,8433,37.5259868,127.1329002
43,306,서울특별시 강동구 성내동,8385,11606,4144,6393,12529,17999,37.5302922,127.1287651
44,307,서울특별시 강동구 암사1동,1368,1787,621,1076,1989,2863,37.5514287,127.1325655
45,308,서울특별시 강동구 암사3동,3192,12237,1510,6845,4702,19082,37.5552053,127.1382039
46,309,서울특별시 강동구 암사동,1758,2568,924,1257,2682,3825,37.558248,127.1304539
47,310,서울특별시 강동구 천호1동,36,548,15,379,51,927,37.54506850000001,127.1367043
48,311,서울특별시 강동구 천호2동,14933,8403,10478,5513,25411,13916,37.543462,127.1231788
49,312,서울특별시 강동구 천호3동,137,344,67,222,204,566,37.539763,127.1297892
50,313,서울특별시 강동구 천호동,10811,10375,5376,6032,16187,16407,37.5439937,127.1256452
51,314,서울특별시 강북구 미아동,44762,36655,26180,23213,70942,59868,37.6268335,127.0269077
52,315,서울특별시 강북구 번1동,2466,3220,1102,1910,3568,5130,37.6378322,127.0287962
53,316,서울특별시 강북구 번2동,864,2623,449,1956,1313,4579,37.6321391,127.0386284
54,317,서울특별시 강북구 번3동,4826,9343,2150,5438,6976,14781,37.625834,127.0465718
55,318,서울특별시 강북구 번동,23856,15882,14962,10153,38818,26035,37.6279206,127.037216
56,319,서울특별시 강북구 삼각산동,860,2235,414,1448,1274,3683,37.6166126,127.0174369
57,320,서울특별시 강북구 삼양동,2665,8647,1206,5469,3871,14116,37.620695,127.0127143
58,321,서울특별시 강북구 송중동,29950,29740,18898,18602,48848,48342,37.615974,127.0336574
59,322,서울특별시 강북구 송천동,1224,2326,635,1297,1859,3623,37.61808449999999,127.0237133
60,323,서울특별시 강북구 수유1동,1511,4148,613,2696,2124,6844,37.6387326,127.0089103
61,324,서울특별시 강북구 수유2동,1846,4063,812,2750,2658,6813,37.6446372,127.0198799
62,325,서울특별시 강북구 수유3동,306,780,101,385,407,1165,37.63886,127.0231577
63,326,서울특별시 강북구 수유동,53932,56531,32515,35472,86447,92003,37.6387326,127.0089103
64,327,서울특별시 강북구 우이동,5816,7716,1947,4967,7763,12683,37.6479697,127.0118806
65,328,서울특별시 강북구 인수동,442,2361,146,1596,588,3957,37.6351934,127.0191862
66,329,서울특별시 강서구 가양1동,20606,7069,8841,3131,29447,10200,37.5691433,126.8403436
67,330,서울특별시 강서구 가양2동,1510,1844,785,909,2295,2753,37.5672827,126.8510926
68,331,서울특별시 강서구 가양3동,864,1819,505,996,1369,2815,37.5610056,126.8604808
69,332,서울특별시 강서구 가양동,2292,5012,1062,2597,3354,7609,37.5648322,126.8342406
70,333,서울특별시 강서구 개화동,155,149,27,49,182,198,37.5859845,126.8040311
71,334,서울특별시 강서구 공항동,9743,9542,2937,4856,12680,14398,37.558949,126.8103748
72,335,서울특별시 강서구 과해동,203,72,36,17,239,89,37.5665478,126.7865769
73,336,서울특별시 강서구 내발산동,5843,6376,2119,3243,7962,9619,37.5546422,126.834636
74,337,서울특별시 강서구 등촌1동,5256,8869,2595,4930,7851,13799,37.5558122,126.8589261
75,338,서울특별시 강서구 등촌2동,2635,9313,1025,5715,3660,15028,37.5425909,126.8624812
76,339,서울특별시 강서구 등촌3동,4300,5538,1313,2692,5613,8230,37.5588666,126.8477051
77,340,서울특별시 강서구 등촌동,16301,14781,8070,7313,24371,22094,37.558653,126.8532512
78,341,서울특별시 강서구 마곡동,5695,3587,2414,1888,8109,5475,37.5764888,126.8307466
79,342,서울특별시 강서구 발산1동,5824,7337,2081,4403,7905,11740,37.5530061,126.8333727
80,343,서울특별시 강서구 방화1동,2710,3993,829,2383,3539,6376,37.5714755,126.8122083
81,344,서울특별시 강서구 방화2동,808,816,317,497,1125,1313,37.566671,126.8066809
82,345,서울특별시 강서구 방화3동,579,1822,162,1162,741,2984,37.5785856,126.8136239
83,346,서울특별시 강서구 방화동,4343,3735,871,1969,5214,5704,37.5764563,126.813873
84,347,서울특별시 강서구 염창동,11330,23511,4992,12356,16322,35867,37.5540319,126.8717993
85,348,서울특별시 강서구 외발산동,336,1136,56,583,392,1719,37.5472236,126.8210719
86,349,서울특별시 강서구 우장산동,5753,3479,2404,1543,8157,5022,37.5480629,126.841817
87,350,서울특별시 강서구 화곡1동,2633,6302,1244,3859,3877,10161,37.530398,126.8415945
88,351,서울특별시 강서구 화곡2동,466,1623,186,1040,652,2663,37.5319531,126.8544552
89,352,서울특별시 강서구 화곡3동,828,1886,496,884,1324,2770,37.5425905,126.8382335
90,353,서울특별시 강서구 화곡4동,1222,4432,653,3076,1875,7508,37.5330091,126.8632873
91,354,서울특별시 강서구 화곡6동,9421,13074,4977,7616,14398,20690,37.5517566,126.8500661
92,355,서울특별시 강서구 화곡8동,9078,7389,5542,4262,14620,11651,37.53267590000001,126.8485388
93,356,서울특별시 강서구 화곡동,38450,44036,20668,24482,59118,68518,37.53811839999999,126.8471024
94,357,서울특별시 강서구 화곡본동,3330,6195,1895,3426,5225,9621,37.53811839999999,126.8471024
95,358,서울특별시 관악구 낙성대동,6274,7928,3745,5037,10019,12965,37.4762397,126.9583907
96,359,서울특별시 관악구 난곡동,1952,9660,850,6771,2802,16431,37.4693789,126.9202006
97,360,서울특별시 관악구 난향동,791,2137,315,1417,1106,3554,37.4616858,126.9188389
98,361,서울특별시 관악구 남현동,2854,10145,1698,6662,4552,16807,37.4675553,126.9794198
99,362,서울특별시 관악구 대학동,283,3311,112,2618,395,5929,37.470546,126.9368929
100,363,서울특별시 관악구 미성동,5109,11707,2812,7444,7921,19151,37.476128,126.9156168
101,364,서울특별시 관악구 보라매동,4249,5447,2131,3082,6380,8529,37.4880718,126.9326988
102,365,서울특별시 관악구 봉천동,74203,73906,44526,45329,118729,119235,37.4794085,126.9535822
103,366,서울특별시 관악구 삼성동,4870,10186,2617,7114,7487,17300,37.470074,126.9329493
104,367,서울특별시 관악구 서림동,6214,14963,3208,10748,9422,25711,37.4749615,126.934949
105,368,서울특별시 관악구 서원동,2152,838,1366,518,3518,1356,37.4797388,126.9313932
106,369,서울특별시 관악구 성현동,1771,13571,1010,8548,2781,22119,37.4894329,126.9481693
107,370,서울특별시 관악구 신림동,146934,99706,88750,63586,235684,163292,37.4626176,126.9383251
108,371,서울특별시 관악구 신사동,4487,3470,2229,1713,6716,5183,37.48529389999999,126.9180613
109,372,서울특별시 관악구 신원동,177,1708,93,1169,270,2877,37.4815445,126.9273105
110,373,서울특별시 관악구 은천동,2637,8679,1405,5719,4042,14398,37.4869051,126.94142
111,374,서울특별시 관악구 인헌동,687,4817,308,3237,995,8054,37.475074,126.965307
112,375,서울특별시 관악구 조원동,7272,14196,3509,8026,10781,22222,37.4810442,126.9090343
113,376,서울특별시 관악구 중앙동,2796,3586,1310,2079,4106,5665,37.4841276,126.9497523
114,377,서울특별시 관악구 청룡동,333,1243,212,815,545,2058,37.4791001,126.9416142
115,378,서울특별시 관악구 청림동,782,7219,391,4610,1173,11829,37.4917938,126.9586402
116,379,서울특별시 관악구 행운동,20276,9138,11968,5175,32244,14313,37.4805452,126.9571127
117,380,서울특별시 광진구 광장동,5457,7196,2456,3816,7913,11012,37.5478086,127.1052825
118,381,서울특별시 광진구 구의1동,4475,341,1940,114,6415,455,37.5424289,127.0857094
119,382,서울특별시 광진구 구의2동,1006,3103,512,1770,1518,4873,37.5473444,127.0900148
120,383,서울특별시 광진구 구의3동,1774,3647,685,2070,2459,5717,37.5389296,127.0976813
121,384,서울특별시 광진구 구의동,21680,17797,10530,9460,32210,27257,37.5466951,127.0914159
122,385,서울특별시 광진구 군자동,7986,14037,4825,9002,12811,23039,37.5530066,127.0736292
123,386,서울특별시 광진구 능동,8427,10218,5637,6270,14064,16488,37.5535934,127.0791827
124,387,서울특별시 광진구 자양1동,2668,8327,1129,4816,3797,13143,37.5344848,127.0822379
125,388,서울특별시 광진구 자양2동,228,872,54,342,282,1214,37.5287076,127.0846269
126,389,서울특별시 광진구 자양3동,1830,4247,706,2406,2536,6653,37.5337907,127.0729889
127,390,서울특별시 광진구 자양4동,860,1769,435,763,1295,2532,37.54015080000001,127.0650175
128,391,서울특별시 광진구 자양동,25884,25235,13993,13557,39877,38792,37.5324005,127.0715809
129,392,서울특별시 광진구 중곡1동,1498,2751,931,2082,2429,4833,37.5606486,127.0799594
130,393,서울특별시 광진구 중곡2동,635,1480,357,1083,992,2563,37.5602037,127.0815433
131,394,서울특별시 광진구 중곡3동,1923,3726,929,2434,2852,6160,37.5687026,127.0800152
132,395,서울특별시 광진구 중곡4동,2290,5639,881,2841,3171,8480,37.5653701,127.0874036
133,396,서울특별시 광진구 중곡동,6377,11093,2709,5992,9086,17085,37.5626197,127.0853672
134,397,서울특별시 광진구 화양동,17821,10260,11817,5802,29638,16062,37.5435547,127.073456
135,398,서울특별시 구로구 가리봉동,2714,4068,1444,2458,4158,6526,37.4823943,126.888251
136,399,서울특별시 구로구 개봉1동,23199,23445,12387,13880,35586,37325,37.5021516,126.8471508
137,400,서울특별시 구로구 개봉2동,6097,2199,3515,1279,9612,3478,37.4907641,126.8564832
138,401,서울특별시 구로구 개봉3동,557,3145,188,2126,745,5271,37.4859037,126.8537616
139,402,서울특별시 구로구 개봉동,4032,12575,2075,7832,6107,20407,37.4888722,126.8557494
140,403,서울특별시 구로구 고척1동,6832,6742,3020,4330,9852,11072,37.50037409999999,126.8627053
141,404,서울특별시 구로구 고척2동,2799,5862,1621,4377,4420,10239,37.5065122,126.8583166
142,405,서울특별시 구로구 고척동,4691,14847,1981,9503,6672,24350,37.5011414,126.8625002
143,406,서울특별시 구로구 구로1동,453,2915,249,2107,702,5022,37.4929862,126.8757043
144,407,서울특별시 구로구 구로2동,2616,5969,1704,3030,4320,8999,37.4912925,126.8834535
145,408,서울특별시 구로구 구로3동,31811,11346,20998,5910,52809,17256,37.4859324,126.8932857
146,409,서울특별시 구로구 구로4동,6494,1923,3275,936,9769,2859,37.4855983,126.8866194
147,410,서울특별시 구로구 구로5동,1238,1587,642,922,1880,2509,37.5000966,126.8893137
148,411,서울특별시 구로구 구로동,76445,56111,46721,29576,123166,85687,37.4951854,126.8820641
149,412,서울특별시 구로구 궁동,3283,5353,1525,3234,4808,8587,37.5003075,126.8289067
150,413,서울특별시 구로구 수궁동,631,3555,298,2261,929,5816,37.49390229999999,126.8314305
151,414,서울특별시 구로구 신도림동,7388,13170,2845,7113,10233,20283,37.5077345,126.8805914
152,415,서울특별시 구로구 오류1동,3818,8091,2171,4611,5989,12702,37.4967632,126.8450681
153,416,서울특별시 구로구 오류2동,2411,8045,1208,4843,3619,12888,37.4887641,126.8395129
154,417,서울특별시 구로구 오류동,6269,4308,3584,2624,9853,6932,37.4901258,126.8385254
155,418,서울특별시 구로구 온수동,9043,3483,5384,1858,14427,5341,37.4939934,126.8206441
156,419,서울특별시 구로구 천왕동,2527,2249,1165,1350,3692,3599,37.4803813,126.8415075
157,420,서울특별시 구로구 항동,976,4540,382,2811,1358,7351,37.481088,126.8250625
158,421,서울특별시 금천구 가산동,30066,22658,14479,13445,44545,36103,37.4758795,126.8838298
159,422,서울특별시 금천구 독산1동,11622,18668,5937,11439,17559,30107,37.4700734,126.8969528
160,423,서울특별시 금천구 독산2동,3233,6567,1793,4358,5026,10925,37.4659619,126.8997027
161,424,서울특별시 금천구 독산3동,15976,17930,9304,10498,25280,28428,37.4765728,126.9080626
162,425,서울특별시 금천구 독산4동,7784,9531,3869,5758,11653,15289,37.4676288,126.9020634
163,426,서울특별시 금천구 독산동,6124,14830,2901,9039,9025,23869,37.4681147,126.8981937
164,427,서울특별시 금천구 시흥1동,20596,20201,10791,11914,31387,32115,37.4535195,126.9031187
165,428,서울특별시 금천구 시흥2동,3591,13810,1781,9565,5372,23375,37.4501312,126.9165345
166,429,서울특별시 금천구 시흥3동,1062,3525,488,1870,1550,5395,37.4402712,126.9057858
167,430,서울특별시 금천구 시흥4동,974,5381,565,3412,1539,8793,37.4589629,126.9060902
168,431,서울특별시 금천구 시흥5동,4837,11026,2074,7405,6911,18431,37.4492857,126.9104662
169,432,서울특별시 금천구 시흥동,6386,11743,3625,6968,10011,18711,37.4492857,126.9104662
170,433,서울특별시 노원구 공릉1동,5560,6075,3466,3142,9026,9217,37.6248346,127.0737922
171,434,서울특별시 노원구 공릉2동,5788,9130,3476,5043,9264,14173,37.6211412,127.0832634
172,435,서울특별시 노원구 공릉동,10672,13363,6137,7673,16809,21036,37.6304778,127.0901988
173,436,서울특별시 노원구 상계10동,1812,1227,1327,763,3139,1990,37.66121890000001,127.0601815
174,437,서울특별시 노원구 상계1동,1766,5071,962,2994,2728,8065,37.6796616,127.0549865
175,438,서울특별시 노원구 상계2동,6395,2174,4136,1514,10531,3688,37.6587754,127.0684857
176,439,서울특별시 노원구 상계3.4동,837,2789,334,1631,1171,4420,37.66377490000001,127.0753459
177,440,서울특별시 노원구 상계5동,1474,4436,561,2924,2035,7360,37.6628859,127.0693465
178,441,서울특별시 노원구 상계6.7동,1829,1159,753,613,2582,1772,37.6530259,127.0581539
179,442,서울특별시 노원구 상계9동,527,2860,207,1801,734,4661,37.6644966,127.063792
180,443,서울특별시 노원구 상계동,49369,33560,27158,18428,76527,51988,37.67480279999999,127.0730618
181,444,서울특별시 노원구 월계1동,1064,3069,703,2180,1767,5249,37.61983499999999,127.0629324
182,445,서울특별시 노원구 월계2동,1591,1637,782,1087,2373,2724,37.6324443,127.0507382
183,446,서울특별시 노원구 월계3동,3422,4740,1507,2693,4929,7433,37.620919,127.0692367
184,447,서울특별시 노원구 월계동,15406,21727,10211,13758,25617,35485,37.6277451,127.0568215
185,448,서울특별시 노원구 중계1동,2511,1900,676,1264,3187,3164,37.6525543,127.077485
186,449,서울특별시 노원구 중계2.3동,137,247,67,136,204,383,37.6406105,127.0651536
187,450,서울특별시 노원구 중계동,35838,35606,15300,18866,51138,54472,37.6514398,127.0831273
188,451,서울특별시 노원구 중계본동,10030,4063,1944,2733,11974,6796,37.6477769,127.0802349
189,452,서울특별시 노원구 하계1동,1297,2622,360,1801,1657,4423,37.6405557,127.0725689
190,453,서울특별시 노원구 하계2동,610,1967,256,1284,866,3251,37.6320006,127.0679316
191,454,서울특별시 노원구 하계동,18273,16898,9579,8943,27852,25841,37.637576,127.0725939
192,455,서울특별시 도봉구 도봉1동,960,1733,297,989,1257,2722,37.6786055,127.0433486
193,456,서울특별시 도봉구 도봉2동,6626,4520,4353,2916,10979,7436,37.6695786,127.0464596
194,457,서울특별시 도봉구 도봉동,5761,10062,2851,5881,8612,15943,37.6837277,127.0318174
195,458,서울특별시 도봉구 방학1동,1823,4136,865,2356,2688,6492,37.6641352,127.0406833
196,459,서울특별시 도봉구 방학2동,1377,4855,492,2795,1869,7650,37.6683016,127.0350997
197,460,서울특별시 도봉구 방학3동,886,3175,240,2285,1126,5460,37.6591356,127.0279067
198,461,서울특별시 도봉구 방학동,12632,27858,5791,18392,18423,46250,37.6641352,127.0406833
199,462,서울특별시 도봉구 쌍문1동,2042,7257,1089,5139,3131,12396,37.6479979,127.0260462
200,463,서울특별시 도봉구 쌍문2동,1442,4049,580,2784,2022,6833,37.6579969,127.0388217
201,464,서울특별시 도봉구 쌍문3동,204,714,113,402,317,1116,37.6488868,127.027851
202,465,서울특별시 도봉구 쌍문4동,1484,5228,596,3481,2080,8709,37.6564409,127.0284897
203,466,서울특별시 도봉구 쌍문동,36940,25399,22180,15554,59120,40953,37.6522545,127.0304855
204,467,서울특별시 도봉구 창1동,250,1029,140,591,390,1620,37.6483312,127.0437665
205,468,서울특별시 도봉구 창2동,842,3330,339,2273,1181,5603,37.6412489,127.0354345
206,469,서울특별시 도봉구 창3동,45,325,36,253,81,578,37.6379994,127.0428778
207,470,서울특별시 도봉구 창4동,10313,8011,6261,4650,16574,12661,37.6521919,127.0515706
208,471,서울특별시 도봉구 창5동,1494,5296,840,3937,2334,9233,37.6519147,127.0390998
209,472,서울특별시 도봉구 창동,20034,28083,11398,16423,31432,44506,37.648965,127.0433646
210,473,서울특별시 동대문구 답십리1동,2299,4209,1179,2447,3478,6656,37.5716467,127.0515179
211,474,서울특별시 동대문구 답십리2동,4267,8166,2314,4963,6581,13129,37.5720638,127.0594611
212,475,서울특별시 동대문구 답십리동,4203,7179,2246,4451,6449,11630,37.5696589,127.0576058
213,476,서울특별시 동대문구 신설동,2418,2623,1447,1654,3865,4277,37.5748653,127.0254662
214,477,서울특별시 동대문구 용두동,12797,15490,6912,9995,19709,25485,37.5757009,127.034989
215,478,서울특별시 동대문구 용신동,13116,10845,8464,7335,21580,18180,37.5762288,127.0302138
216,479,서울특별시 동대문구 이문1동,2760,5821,819,2782,3579,8603,37.594477,127.0565167
217,480,서울특별시 동대문구 이문2동,2288,2409,1750,1643,4038,4052,37.6032541,127.0650987
218,481,서울특별시 동대문구 이문동,4994,8808,2238,5593,7232,14401,37.6004162,127.0655265
219,482,서울특별시 동대문구 장안1동,1298,2785,606,1735,1904,4520,37.5677585,127.0663775
220,483,서울특별시 동대문구 장안2동,3478,5140,1280,3540,4758,8680,37.5783962,127.0705438
221,484,서울특별시 동대문구 장안동,27168,27331,14853,17042,42021,44373,37.570627,127.0706515
222,485,서울특별시 동대문구 전농1동,3124,5272,1787,2940,4911,8212,37.5763402,127.0562953
223,486,서울특별시 동대문구 전농2동,4433,8902,1621,5746,6054,14648,37.578451,127.0576841
224,487,서울특별시 동대문구 전농동,13811,18761,7614,10211,21425,28972,37.5792622,127.0554405
225,488,서울특별시 동대문구 제기동,15155,14828,9373,9879,24528,24707,37.5833567,127.0367969
226,489,서울특별시 동대문구 청량리동,25661,17350,15282,11244,40943,28594,37.588908,127.0445965
227,490,서울특별시 동대문구 회기동,9820,9991,5397,5710,15217,15701,37.5907275,127.055128
228,491,서울특별시 동대문구 휘경1동,7689,9321,4666,5589,12355,14910,37.5928664,127.0656829
229,492,서울특별시 동대문구 휘경2동,938,2111,492,1293,1430,3404,37.5911446,127.0677097
230,493,서울특별시 동대문구 휘경동,8598,7066,4105,3645,12703,10711,37.5900176,127.0636187
231,494,서울특별시 동작구 노량진1동,8098,14526,3939,8916,12037,23442,37.512235,126.9419742
232,495,서울특별시 동작구 노량진2동,5935,1453,1407,636,7342,2089,37.5085134,126.9372528
233,496,서울특별시 동작구 노량진동,55330,23689,30034,13694,85364,37383,37.5110026,126.9416329
234,497,서울특별시 동작구 대방동,18775,27966,9361,16303,28136,44269,37.5080962,126.9262539
235,498,서울특별시 동작구 동작동,2179,1509,1221,741,3400,2250,37.4998616,126.9742991
236,499,서울특별시 동작구 본동,82,76,32,44,114,120,37.51244210000001,126.9534025
237,500,서울특별시 동작구 사당1동,2759,2289,2104,1462,4863,3751,37.476379,126.9735832
238,501,서울특별시 동작구 사당2동,5587,12511,2279,6462,7866,18973,37.4886556,126.9792213
239,502,서울특별시 동작구 사당3동,1055,4920,355,2523,1410,7443,37.4866557,126.971972
240,503,서울특별시 동작구 사당4동,1648,1987,724,927,2372,2914,37.4809894,126.9715562
241,504,서울특별시 동작구 사당5동,1462,5107,894,2408,2356,7515,37.4857107,126.9667226
242,505,서울특별시 동작구 사당동,28724,22316,15561,12045,44285,34361,37.476379,126.9735832
243,506,서울특별시 동작구 상도1동,14911,22248,8482,13159,23393,35407,37.5027719,126.9504938
244,507,서울특별시 동작구 상도2동,2390,5012,1004,2155,3394,7167,37.5054029,126.9422524
245,508,서울특별시 동작구 상도3동,7522,13625,3111,7507,10633,21132,37.4991534,126.9315036
246,509,서울특별시 동작구 상도4동,2970,13922,1170,8029,4140,21951,37.5004864,126.937725
247,510,서울특별시 동작구 상도동,22109,33478,12722,20636,34831,54114,37.4989895,126.9377193
248,511,서울특별시 동작구 신대방1동,2958,3486,967,2181,3925,5667,37.4889593,126.909978
249,512,서울특별시 동작구 신대방2동,671,2840,491,1702,1162,4542,37.4989034,126.9258932
250,513,서울특별시 동작구 신대방동,22909,17234,12960,9410,35869,26644,37.4915587,126.9166265
251,514,서울특별시 동작구 흑석동,18230,21711,10920,14292,29150,36003,37.5094857,126.9605285
252,515,서울특별시 마포구 공덕동,8285,13145,5175,7520,13460,20665,37.54686969999999,126.9521717
253,516,서울특별시 마포구 대흥동,29922,19275,13721,11317,43643,30592,37.5498977,126.9427769
254,517,서울특별시 마포구 도화동,16038,14624,9409,8474,25447,23098,37.5376491,126.9501677
255,518,서울특별시 마포구 동교동,48503,15004,32155,8167,80658,23171,37.5576862,126.923487
256,519,서울특별시 마포구 망원1동,5139,5324,3104,3208,8243,8532,37.55511810000001,126.9055326
257,520,서울특별시 마포구 망원2동,1455,4034,892,2758,2347,6792,37.5602564,126.9022268
258,521,서울특별시 마포구 망원동,3833,5926,1520,4150,5353,10076,37.5559772,126.9012821
259,522,서울특별시 마포구 상수동,1056,868,793,573,1849,1441,37.5454728,126.9244174
260,523,서울특별시 마포구 상암동,37658,29236,18405,17848,56063,47084,37.5781711,126.894616
261,524,서울특별시 마포구 서강동,4198,5725,2500,3212,6698,8937,37.5480085,126.9324192
262,525,서울특별시 마포구 서교동,63487,30671,40389,19078,103876,49749,37.5534897,126.9177304
263,526,서울특별시 마포구 성산1동,4173,10614,1754,6972,5927,17586,37.5632282,126.9078651
264,527,서울특별시 마포구 성산2동,10400,12891,4356,7339,14756,20230,37.5657426,126.9033058
265,528,서울특별시 마포구 성산동,5316,7675,2304,4600,7620,12275,37.5657426,126.9033058
266,529,서울특별시 마포구 신공덕동,911,1436,359,769,1270,2205,37.54459170000001,126.9557029
267,530,서울특별시 마포구 신수동,2588,4160,1281,2414,3869,6574,37.54684170000001,126.934558
268,531,서울특별시 마포구 아현동,12818,14591,6755,8197,19573,22788,37.5541171,126.9569379
269,532,서울특별시 마포구 연남동,4209,3564,1665,2232,5874,5796,37.5644783,126.9220027
270,533,서울특별시 마포구 염리동,2874,3908,950,1987,3824,5895,37.5496169,126.9476266
271,534,서울특별시 마포구 용강동,1403,1698,791,1120,2194,2818,37.5417874,126.9416684
272,535,서울특별시 마포구 중동,339,1620,145,976,484,2596,37.5725438,126.9048389
273,536,서울특별시 마포구 창전동,681,1557,292,818,973,2375,37.5501124,126.9309867
274,537,서울특별시 마포구 하중동,83,99,39,56,122,155,37.5429708,126.9277011
275,538,서울특별시 마포구 합정동,7475,5003,4791,2915,12266,7918,37.5463089,126.9101219
276,539,서울특별시 서대문구 남가좌1동,3761,5545,2282,3545,6043,9090,37.574005,126.9133923
277,540,서울특별시 서대문구 남가좌2동,3110,9460,1575,5952,4685,15412,37.5784486,126.9237802
278,541,서울특별시 서대문구 남가좌동,6375,16740,3093,11947,9468,28687,37.5743455,126.9188972
279,542,서울특별시 서대문구 냉천동,189,60,107,56,296,116,37.5668216,126.962263
280,543,서울특별시 서대문구 대신동,1588,4378,736,2304,2324,6682,37.5677894,126.9488821
281,544,서울특별시 서대문구 대현동,12654,13212,6925,7772,19579,20984,37.5606558,126.9465796
282,545,서울특별시 서대문구 북가좌1동,2927,6953,1474,3816,4401,10769,37.5795042,126.9069208
283,546,서울특별시 서대문구 북가좌2동,1284,4425,629,2944,1913,7369,37.581421,126.9111143
284,547,서울특별시 서대문구 북가좌동,4346,10295,2603,6183,6949,16478,37.5784186,126.9099561
285,548,서울특별시 서대문구 북아현동,9590,12858,2497,5545,12087,18403,37.56096770000001,126.9542682
286,549,서울특별시 서대문구 신촌동,44102,23428,23699,14150,67801,37578,37.5594793,126.9435838
287,550,서울특별시 서대문구 연희동,34346,44802,18867,28735,53213,73537,37.5717975,126.9325254
288,551,서울특별시 서대문구 영천동,6498,6595,2988,3407,9486,10002,37.5699488,126.9563277
289,552,서울특별시 서대문구 창천동,16572,4763,8927,2442,25499,7205,37.5584944,126.9345627
290,553,서울특별시 서대문구 천연동,2907,6889,1661,4463,4568,11352,37.57106210000001,126.9590269
291,554,서울특별시 서대문구 충정로2가,462,162,348,105,810,267,37.5646792,126.9640448
292,555,서울특별시 서대문구 충정로3가,3800,2673,2450,1823,6250,4496,37.5618617,126.9616111
293,556,서울특별시 서대문구 충현동,8567,11343,4524,4721,13091,16064,37.5628962,126.9623598
294,557,서울특별시 서대문구 현저동,0,12,0,13,0,25,37.5737003,126.9533655
295,558,서울특별시 서대문구 홍은1동,4500,5842,2296,3364,6796,9206,37.5931972,126.9438888
296,559,서울특별시 서대문구 홍은2동,4290,13310,2265,8497,6555,21807,37.5828653,126.9364458
297,560,서울특별시 서대문구 홍은동,9081,20518,4268,12453,13349,32971,37.5871322,126.9319759
298,561,서울특별시 서대문구 홍제1동,5309,5883,3173,3176,8482,9059,37.5877538,126.9451388
299,562,서울특별시 서대문구 홍제2동,2106,5255,1304,3247,3410,8502,37.58592110000001,126.9491105
300,563,서울특별시 서대문구 홍제3동,2121,4163,1039,2080,3160,6243,37.5939752,126.9495272
301,564,서울특별시 서대문구 홍제동,15998,11061,7201,6057,23199,17118,37.58551120000001,126.9489831
302,565,서울특별시 서초구 내곡동,2847,6679,1151,4107,3998,10786,37.4617711,127.05116
303,566,서울특별시 서초구 반포1동,1081,1931,252,580,1333,2511,37.506043,127.0126625
304,567,서울특별시 서초구 반포2동,3707,912,1445,267,5152,1179,37.5044869,126.9944423
305,568,서울특별시 서초구 반포3동,20,19,19,3,39,22,37.5119312,127.0055521
306,569,서울특별시 서초구 반포4동,36661,20887,18655,9346,55316,30233,37.4975719,127.000386
307,570,서울특별시 서초구 반포동,35532,26996,21676,15574,57208,42570,37.5031833,127.0079167
308,571,서울특별시 서초구 반포본동,2637,3046,1629,1878,4266,4924,37.5031833,127.0079167
309,572,서울특별시 서초구 방배1동,1574,3623,775,1414,2349,5037,37.4832955,126.9944149
310,573,서울특별시 서초구 방배2동,571,1301,174,408,745,1709,37.4798788,126.9854989
311,574,서울특별시 서초구 방배3동,947,2082,679,1186,1626,3268,37.480185,126.9990806
312,575,서울특별시 서초구 방배4동,2173,2900,1102,1288,3275,4188,37.4895447,126.9912761
313,576,서울특별시 서초구 방배동,47736,42804,26357,20780,74093,63584,37.4799348,126.9934602
314,577,서울특별시 서초구 방배본동,424,794,48,194,472,988,37.4941271,126.9887762
315,578,서울특별시 서초구 서초1동,4471,4872,1710,1882,6181,6754,37.4887673,127.0190234
316,579,서울특별시 서초구 서초2동,5161,5649,1801,2392,6962,8041,37.492017,127.0247167
317,580,서울특별시 서초구 서초3동,7980,6630,2933,2239,10913,8869,37.4836008,127.0124412
318,581,서울특별시 서초구 서초4동,5259,3690,2457,1848,7716,5538,37.5026266,127.0221057
319,582,서울특별시 서초구 서초동,57440,45521,21311,20709,78751,66230,37.4876872,127.0174271
320,583,서울특별시 서초구 양재1동,14820,19230,9373,11699,24193,30929,37.4844071,127.0361048
321,584,서울특별시 서초구 양재2동,3434,5814,1564,3579,4998,9393,37.4707419,127.0413547
322,585,서울특별시 서초구 양재동,18191,17487,7952,9173,26143,26660,37.4731977,127.0381702
323,586,서울특별시 서초구 염곡동,181,327,73,232,254,559,37.463043,127.0544047
324,587,서울특별시 서초구 우면동,1325,7070,409,3338,1734,10408,37.4651959,127.0164423
325,588,서울특별시 서초구 원지동,147,145,17,65,164,210,37.4423018,127.0498797
326,589,서울특별시 서초구 잠원동,16414,27972,9133,15887,25547,43859,37.514847,127.0143281
327,590,서울특별시 성동구 금호1가동,507,4740,281,2750,788,7490,37.5547592,127.0211043
328,591,서울특별시 성동구 금호2.3가동,4649,6483,2637,3183,7286,9666,37.5529815,127.0211044
329,592,서울특별시 성동구 금호4가동,2576,2906,1356,1629,3932,4535,37.5472602,127.0223264
330,593,서울특별시 성동구 금호동1가,3792,6237,1519,3143,5311,9380,37.5543643,127.0244491
331,594,서울특별시 성동구 금호동2가,599,1067,299,449,898,1516,37.5519831,127.0230371
332,595,서울특별시 성동구 금호동3가,1815,1632,348,546,2163,2178,37.5495775,127.0211452
333,596,서울특별시 성동구 금호동4가,1379,2010,478,1018,1857,3028,37.5452268,127.025308
334,597,서울특별시 성동구 마장동,5318,7194,2341,3646,7659,10840,37.5662583,127.0453796
335,598,서울특별시 성동구 사근동,5653,4259,3676,2248,9329,6507,37.5610919,127.0459627
336,599,서울특별시 성동구 성수1가1동,4249,2352,1887,1075,6136,3427,37.5393726,127.0475472
337,600,서울특별시 성동구 성수1가2동,4079,1631,1869,843,5948,2474,37.5462887,127.0442133
338,601,서울특별시 성동구 성수2가1동,2015,2448,812,1403,2827,3851,37.5394557,127.0540185
339,602,서울특별시 성동구 성수2가3동,1980,2437,1091,1702,3071,4139,37.5483166,127.0549622
340,603,서울특별시 성동구 성수동1가,3399,3482,1506,2019,4905,5501,37.5435182,127.0437247
341,604,서울특별시 성동구 성수동2가,12130,13105,6801,7856,18931,20961,37.5394428,127.0542534
342,605,서울특별시 성동구 송정동,2561,5086,1186,3366,3747,8452,37.5527653,127.0608277
343,606,서울특별시 성동구 옥수동,8488,9401,4430,5264,12918,14665,37.54359350000001,127.0134664
344,607,서울특별시 성동구 왕십리2동,6084,7201,3731,4161,9815,11362,37.5610086,127.0304642
345,608,서울특별시 성동구 왕십리도선동,8737,6347,5897,3574,14634,9921,37.5659801,127.031437
346,609,서울특별시 성동구 용답동,11780,12091,7286,7674,19066,19765,37.5640647,127.0554067
347,610,서울특별시 성동구 응봉동,1587,8161,902,4958,2489,13119,37.5505499,127.0341139
348,611,서울특별시 성동구 하왕십리동,3535,4042,1993,2363,5528,6405,37.5689559,127.0279598
349,612,서울특별시 성동구 행당1동,5997,4586,3574,2315,9571,6901,37.5584261,127.0361028
350,613,서울특별시 성동구 행당2동,3434,1625,1600,865,5034,2490,37.55787,127.0292984
351,614,서울특별시 성동구 행당동,19344,10827,10096,5854,29440,16681,37.5574629,127.0347413
352,615,서울특별시 성동구 홍익동,510,629,200,249,710,878,37.5662961,127.0317252
353,616,서울특별시 성북구 길음1동,16092,20166,8927,12536,25019,32702,37.6041422,127.0221588
354,617,서울특별시 성북구 길음2동,4467,4848,1918,3016,6385,7864,37.606614,127.0272973
355,618,서울특별시 성북구 길음동,1281,5439,456,3538,1737,8977,37.6073126,127.023926
356,619,서울특별시 성북구 돈암1동,92,174,37,68,129,242,37.6033644,127.0264084
357,620,서울특별시 성북구 돈암2동,1174,3399,539,2039,1713,5438,37.5978368,127.0107711
358,621,서울특별시 성북구 돈암동,21580,23396,12995,15301,34575,38697,37.6005277,127.023636
359,622,서울특별시 성북구 동선동,21837,14726,14138,10022,35975,24748,37.5935604,127.0157427
360,623,서울특별시 성북구 동선동2가,333,56,215,27,548,83,37.5901288,127.0200219
361,624,서울특별시 성북구 동선동4가,11892,2983,7756,1786,19648,4769,37.5952422,127.0188196
362,625,서울특별시 성북구 동소문동1가,4207,955,2831,614,7038,1569,37.5899255,127.0074184
363,626,서울특별시 성북구 동소문동2가,9239,11113,6250,7451,15489,18564,37.58880360000001,127.0083383
364,627,서울특별시 성북구 동소문동4가,611,44,278,14,889,58,37.5915901,127.0107586
365,628,서울특별시 성북구 동소문동5가,4538,1031,3034,878,7572,1909,37.5917188,127.0152386
366,629,서울특별시 성북구 동소문동7가,1301,1839,499,1053,1800,2892,37.5961103,127.0142669
367,630,서울특별시 성북구 보문동,3773,3983,2624,2179,6397,6162,37.5803121,127.0227704
368,631,서울특별시 성북구 보문동5가,911,1978,630,1105,1541,3083,37.5823256,127.0200777
369,632,서울특별시 성북구 보문동7가,1177,2112,576,1008,1753,3120,37.5797898,127.0225999
370,633,서울특별시 성북구 삼선동,2436,5242,1184,3288,3620,8530,37.5939763,127.0105212
371,634,서울특별시 성북구 삼선동2가,3,39,4,37,7,76,37.5829592,127.0120379
372,635,서울특별시 성북구 삼선동3가,24,16,8,9,32,25,37.5866444,127.0127559
373,636,서울특별시 성북구 삼선동4가,8186,5782,4356,3282,12542,9064,37.5896877,127.0129667
374,637,서울특별시 성북구 삼선동5가,3815,4569,2170,2603,5985,7172,37.5885021,127.0155886
375,638,서울특별시 성북구 상월곡동,1586,3949,973,3142,2559,7091,37.603604,127.0499508
376,639,서울특별시 성북구 석관동,15366,8209,9930,5065,25296,13274,37.6084827,127.0609186
377,640,서울특별시 성북구 성북동,9130,8020,5185,4642,14315,12662,37.5909485,127.003439
378,641,서울특별시 성북구 성북동1가,575,931,310,523,885,1454,37.5893957,127.0038114
379,642,서울특별시 성북구 안암동,3113,3521,2107,2149,5220,5670,37.5858384,127.0213534
380,643,서울특별시 성북구 안암동1가,32,85,23,80,55,165,37.5884727,127.0215331
381,644,서울특별시 성북구 안암동2가,494,1050,347,704,841,1754,37.5871412,127.0231089
382,645,서울특별시 성북구 안암동5가,7039,7598,5246,4818,12285,12416,37.5866998,127.0290956
383,646,서울특별시 성북구 월곡1동,2012,3304,1353,1966,3365,5270,37.610225,127.0374875
384,647,서울특별시 성북구 월곡2동,4573,3959,2776,2436,7349,6395,37.6025867,127.0394902
385,648,서울특별시 성북구 장위1동,1806,9132,780,6307,2586,15439,37.6139744,127.0436564
386,649,서울특별시 성북구 장위2동,1025,1604,469,1105,1494,2709,37.6122528,127.0545994
387,650,서울특별시 성북구 장위3동,2254,4951,1259,2853,3513,7804,37.6165023,127.0565711
388,651,서울특별시 성북구 장위동,8916,13600,5502,9164,14418,22764,37.6156087,127.0507954
389,652,서울특별시 성북구 정릉1동,3778,15066,1794,9785,5572,24851,37.6013925,127.0166034
390,653,서울특별시 성북구 정릉2동,2457,7429,1104,5013,3561,12442,37.604475,127.0109379
391,654,서울특별시 성북구 정릉3동,1495,3432,921,2729,2416,6161,37.6087243,127.0041325
392,655,서울특별시 성북구 정릉4동,2046,9353,1047,6184,3093,15537,37.6133078,127.006965
393,656,서울특별시 성북구 정릉동,18865,27534,9541,17646,28406,45180,37.61449289999999,127.0002306
394,657,서울특별시 성북구 종암동,16171,26381,9224,16541,25395,42922,37.60017089999999,127.031602
395,658,서울특별시 성북구 하월곡동,6597,8944,3211,5410,9808,14354,37.6041779,127.0409997
396,659,서울특별시 송파구 가락1동,8055,10284,4837,6150,12892,16434,37.4964619,127.1055147
397,660,서울특별시 송파구 가락2동,214,637,160,412,374,1049,37.498712,127.1266796
398,661,서울특별시 송파구 가락동,12013,17515,6990,10440,19003,27955,37.4952783,127.1157128
399,662,서울특별시 송파구 가락본동,8813,7509,3674,4476,12487,11985,37.4954903,127.1217072
400,663,서울특별시 송파구 거여1동,605,3433,248,2078,853,5511,37.4970185,127.143372
401,664,서울특별시 송파구 거여2동,1976,3264,1294,2037,3270,5301,37.49349100000001,127.1468718
402,665,서울특별시 송파구 거여동,5733,7792,3189,4286,8922,12078,37.4900434,127.1462058
403,666,서울특별시 송파구 마천1동,1107,4246,720,2888,1827,7134,37.4959357,127.1498994
404,667,서울특별시 송파구 마천2동,557,3334,357,2250,914,5584,37.4968796,127.1485105
405,668,서울특별시 송파구 마천동,3584,8368,1847,5347,5431,13715,37.4976485,127.1530166
406,669,서울특별시 송파구 문정1동,456,2750,234,1590,690,4340,37.490047,127.1241801
407,670,서울특별시 송파구 문정2동,12456,7529,6173,4861,18629,12390,37.4898248,127.1108474
408,671,서울특별시 송파구 문정동,3571,7062,1548,4688,5119,11750,37.4851331,127.1238462
409,672,서울특별시 송파구 방이1동,3013,1842,676,1059,3689,2901,37.5109334,127.1238455
410,673,서울특별시 송파구 방이2동,2997,1922,2502,1572,5499,3494,37.5145158,127.1144024
411,674,서울특별시 송파구 방이동,15514,14044,7984,8567,23498,22611,37.5164031,127.1215351
412,675,서울특별시 송파구 삼전동,4345,8536,2053,5099,6398,13635,37.5027949,127.0925158
413,676,서울특별시 송파구 석촌동,14535,15810,8093,9043,22628,24853,37.503517,127.1035697
414,677,서울특별시 송파구 송파1동,2419,1597,1414,997,3833,2594,37.5058778,127.1096251
415,678,서울특별시 송파구 송파2동,5021,6988,2329,4054,7350,11042,37.5022674,127.1166805
416,679,서울특별시 송파구 송파동,16140,16759,7792,10343,23932,27102,37.50460899999999,127.1119305
417,680,서울특별시 송파구 신천동,17864,10255,7959,5199,25823,15454,37.5200705,127.0995
418,681,서울특별시 송파구 오금동,8420,14122,3700,8498,12120,22620,37.5029895,127.1278734
419,682,서울특별시 송파구 오륜동,5221,2141,3001,998,8222,3139,37.5154331,127.1343724
420,683,서울특별시 송파구 위례동,2382,5557,527,3518,2909,9075,37.5145437,127.1065971
421,684,서울특별시 송파구 잠실2동,714,1828,337,703,1051,2531,37.5156676,127.0856413
422,685,서울특별시 송파구 잠실3동,3248,4396,1503,2142,4751,6538,37.5071834,127.0941266
423,686,서울특별시 송파구 잠실4동,1911,1691,1399,937,3310,2628,37.5200285,127.1084342
424,687,서울특별시 송파구 잠실6동,13707,2555,6910,1478,20617,4033,37.5179042,127.1007366
425,688,서울특별시 송파구 잠실동,56368,34256,33489,16474,89857,50730,37.5061273,127.0842945
426,689,서울특별시 송파구 잠실본동,6611,10323,3506,5300,10117,15623,37.5061273,127.0842945
427,690,서울특별시 송파구 장지동,11649,12992,3485,7910,15134,20902,37.4773867,127.1285282
428,691,서울특별시 송파구 풍납1동,277,595,121,980,398,1575,37.5382351,127.1220949
429,692,서울특별시 송파구 풍납2동,1751,4172,2186,2393,3937,6565,37.5286251,127.1164568
430,693,서울특별시 송파구 풍납동,6960,8514,3935,5318,10895,13832,37.5327384,127.1134887
431,694,서울특별시 양천구 목1동,17751,5303,6553,2641,24304,7944,37.5303155,126.8711197
432,695,서울특별시 양천구 목2동,12367,14048,8118,7960,20485,22008,37.5460906,126.8717032
433,696,서울특별시 양천구 목3동,738,2821,351,1446,1089,4267,37.5448407,126.8643419
434,697,서울특별시 양천구 목4동,1261,3568,517,2152,1778,5720,37.5323423,126.8683419
435,698,서울특별시 양천구 목5동,1038,3866,400,2563,1438,6429,37.5350651,126.8785078
436,699,서울특별시 양천구 목동,76887,56120,31599,30388,108486,86508,37.5370192,126.8735297
437,700,서울특별시 양천구 신월1동,2,486,2,471,4,957,37.5329255,126.8313455
438,701,서울특별시 양천구 신월2동,1613,2765,662,1376,2275,4141,37.5249267,126.8445674
439,702,서울특별시 양천구 신월4동,1482,4528,626,3169,2108,7697,37.519981,126.8365553
440,703,서울특별시 양천구 신월5동,133,1172,40,504,173,1676,37.5396466,126.8273457
441,704,서울특별시 양천구 신월6동,1195,2997,523,1869,1718,4866,37.5160668,126.8436787
442,705,서울특별시 양천구 신월7동,597,3839,230,2084,827,5923,37.5218429,126.8346794
443,706,서울특별시 양천구 신월동,16682,37435,8545,22651,25227,60086,37.519981,126.8365553
444,707,서울특별시 양천구 신정1동,767,2217,529,990,1296,3207,37.5184827,126.8542326
445,708,서울특별시 양천구 신정2동,3580,8094,1537,6275,5117,14369,37.5191779,126.870676
446,709,서울특별시 양천구 신정3동,4385,10869,1796,6761,6181,17630,37.5150671,126.8548167
447,710,서울특별시 양천구 신정4동,609,253,152,104,761,357,37.5233712,126.8586771
448,711,서울특별시 양천구 신정6동,743,2124,276,1022,1019,3146,37.5169831,126.8643707
449,712,서울특별시 양천구 신정7동,1057,2972,386,1682,1443,4654,37.5143723,126.8596492
450,713,서울특별시 양천구 신정동,46831,44533,22098,24432,68929,68965,37.5166014,126.8638714
451,714,서울특별시 영등포구 당산1동,4750,6065,2447,2985,7197,9050,37.5249277,126.8974232
452,715,서울특별시 영등포구 당산2동,2190,3334,1028,2084,3218,5418,37.5347036,126.9021445
453,716,서울특별시 영등포구 당산동,384,1149,213,657,597,1806,37.5391115,126.9033939
454,717,서울특별시 영등포구 당산동2가,267,352,145,156,412,508,37.5223863,126.8938653
455,718,서울특별시 영등포구 당산동3가,4874,2494,3083,1308,7957,3802,37.5255183,126.8972369
456,719,서울특별시 영등포구 당산동4가,373,422,158,256,531,678,37.5287389,126.8995556
457,720,서울특별시 영등포구 당산동5가,2133,2202,444,1113,2577,3315,37.5322248,126.9010187
458,721,서울특별시 영등포구 당산동6가,25610,12674,16763,6286,42373,18960,37.5340872,126.9029485
459,722,서울특별시 영등포구 대림1동,4467,7022,1208,3288,5675,10310,37.4953754,126.9058392
460,723,서울특별시 영등포구 대림2동,2187,3589,1149,1494,3336,5083,37.4926816,126.8982291
461,724,서울특별시 영등포구 대림3동,1044,4862,561,3128,1605,7990,37.498236,126.8980349
462,725,서울특별시 영등포구 대림동,7084,10107,3245,4929,10329,15036,37.4955091,126.899438
463,726,서울특별시 영등포구 도림동,2567,9557,1156,5675,3723,15232,37.5094016,126.8960068
464,727,서울특별시 영등포구 문래동,3986,4775,1887,2979,5873,7754,37.5169837,126.8993953
465,728,서울특별시 영등포구 문래동2가,73,101,10,36,83,137,37.512853,126.8926425
466,729,서울특별시 영등포구 문래동3가,6221,2457,3062,900,9283,3357,37.5176033,126.895289
467,730,서울특별시 영등포구 문래동4가,17,5,2,0,19,5,37.514032,126.8902211
468,731,서울특별시 영등포구 문래동5가,22,154,1,137,23,291,37.5167213,126.8830905
469,732,서울특별시 영등포구 문래동6가,137,797,54,325,191,1122,37.5191463,126.8858554
470,733,서울특별시 영등포구 신길1동,2248,5264,1191,2999,3439,8263,37.5109018,126.9213373
471,734,서울특별시 영등포구 신길3동,1111,3587,481,2042,1592,5629,37.507263,126.9077007
472,735,서울특별시 영등포구 신길4동,745,1788,338,857,1083,2645,37.508319,126.9113663
473,736,서울특별시 영등포구 신길5동,751,917,454,610,1205,1527,37.5015967,126.9052561
474,737,서울특별시 영등포구 신길6동,7363,10826,4389,6006,11752,16832,37.499347,126.9098667
475,738,서울특별시 영등포구 신길7동,1425,1912,576,1029,2001,2941,37.5063464,126.9213654
476,739,서울특별시 영등포구 신길동,22661,39666,10841,20303,33502,59969,37.5062485,126.9139521
477,740,서울특별시 영등포구 양평1동,3381,4940,1827,2540,5208,7480,37.5236497,126.8882292
478,741,서울특별시 영등포구 양평2동,3156,5085,1628,2515,4784,7600,37.5377591,126.895923
479,742,서울특별시 영등포구 양평동1가,930,1399,391,494,1321,1893,37.5231632,126.8886362
480,743,서울특별시 영등포구 양평동3가,369,2358,127,1425,496,3783,37.5289951,126.8924107
481,744,서울특별시 영등포구 양평동4가,2102,1852,677,926,2779,2778,37.5361297,126.8960904
482,745,서울특별시 영등포구 양평동5가,230,242,31,53,261,295,37.5399253,126.8928726
483,746,서울특별시 영등포구 양평동6가,36,1,4,0,40,1,37.542319,126.8890103
484,747,서울특별시 영등포구 양화동,4449,5228,2219,2639,6668,7867,37.5483754,126.8890567
485,748,서울특별시 영등포구 여의도동,63493,23531,30196,12728,93689,36259,37.5175402,126.9345308
486,749,서울특별시 영등포구 여의동,6971,4256,3242,2415,10213,6671,37.5175402,126.9345308
487,750,서울특별시 영등포구 영등포동,7754,6077,4171,3202,11925,9279,37.5132559,126.9057791
488,751,서울특별시 영등포구 영등포동3가,45938,19201,25681,10305,71619,29506,37.5177549,126.907807
489,752,서울특별시 영등포구 영등포동4가,1037,284,435,196,1472,480,37.5175989,126.9037763
490,753,서울특별시 영등포구 영등포동5가,1092,857,740,523,1832,1380,37.5210958,126.9067076
491,754,서울특별시 영등포구 영등포동6가,51,110,17,52,68,162,37.5215695,126.9032507
492,755,서울특별시 영등포구 영등포동7가,1538,2717,746,1635,2284,4352,37.52437279999999,126.9070793
493,756,서울특별시 영등포구 영등포동8가,3429,7180,1616,4057,5045,11237,37.5283387,126.905394
494,757,서울특별시 영등포구 영등포본동,4887,3633,2931,1825,7818,5458,37.5145952,126.9093664
495,758,서울특별시 용산구 갈월동,276,497,187,179,463,676,37.5473301,126.9722574
496,759,서울특별시 용산구 남영동,28965,21223,16978,10460,45943,31683,37.5455655,126.9744151
497,760,서울특별시 용산구 도원동,337,1962,124,1308,461,3270,37.5383838,126.9554387
498,761,서울특별시 용산구 동빙고동,32,19,0,0,32,19,37.5252779,126.9947366
499,762,서울특별시 용산구 문배동,223,406,43,133,266,539,37.5370133,126.9696862
500,763,서울특별시 용산구 보광동,3387,7254,1431,3571,4818,10825,37.5265039,127.0011919
501,764,서울특별시 용산구 산천동,253,1405,103,952,356,2357,37.5352218,126.9508826
502,765,서울특별시 용산구 서계동,1825,5042,893,3462,2718,8504,37.5524394,126.9658264
503,766,서울특별시 용산구 서빙고동,4389,8936,2177,4686,6566,13622,37.520402,126.9945799
504,767,서울특별시 용산구 신계동,448,373,227,181,675,554,37.53528379999999,126.9666019
505,768,서울특별시 용산구 용문동,1759,1839,662,877,2421,2716,37.5383431,126.9584999
506,769,서울특별시 용산구 용산2가동,5667,7252,2668,3961,8335,11213,37.5458707,126.9854421
507,770,서울특별시 용산구 용산동1가,2035,2065,1122,1240,3157,3305,37.5402895,126.9769997
508,771,서울특별시 용산구 용산동2가,1671,2568,478,1258,2149,3826,37.5407943,126.9835695
509,772,서울특별시 용산구 용산동5가,633,378,457,169,1090,547,37.5261782,126.9746368
510,773,서울특별시 용산구 용산동6가,2052,1013,430,603,2482,1616,37.52332699999999,126.9841218
511,774,서울특별시 용산구 원효로1가,2409,2393,1339,1181,3748,3574,37.5399325,126.9674607
512,775,서울특별시 용산구 원효로1동,3360,6569,1868,3790,5228,10359,37.5388162,126.9657772
513,776,서울특별시 용산구 원효로2가,643,843,380,567,1023,1410,37.53600369999999,126.9628655
514,777,서울특별시 용산구 원효로2동,2582,6157,1316,3662,3898,9819,37.53426049999999,126.9515837
515,778,서울특별시 용산구 원효로3가,37,79,9,5,46,84,37.5347545,126.95735
516,779,서울특별시 용산구 원효로4가,0,117,0,72,0,189,37.5323003,126.9504725
517,780,서울특별시 용산구 이촌1동,417,313,153,190,570,503,37.5212905,126.973027
518,781,서울특별시 용산구 이촌2동,5293,4905,2280,2873,7573,7778,37.5268725,126.9541116
519,782,서울특별시 용산구 이촌동,4639,6854,2455,3371,7094,10225,37.5161216,126.9660695
520,783,서울특별시 용산구 이태원1동,51,113,0,0,51,113,37.5323175,126.9949965
521,784,서울특별시 용산구 이태원2동,4791,4868,1655,2870,6446,7738,37.5407324,126.9897188
522,785,서울특별시 용산구 이태원동,16867,14329,9361,7696,26228,22025,37.5400456,126.9921017
523,786,서울특별시 용산구 청암동,47,2,25,2,72,4,37.5343891,126.9461605
524,787,서울특별시 용산구 청파동,2564,5646,1127,2553,3691,8199,37.5435097,126.9696097
525,788,서울특별시 용산구 청파동2가,1642,3652,925,1505,2567,5157,37.54585,126.9680402
526,789,서울특별시 용산구 한강로1가,9818,4789,6021,2839,15839,7628,37.5375702,126.9730964
527,790,서울특별시 용산구 한강로2가,81,90,27,39,108,129,37.5316834,126.9696924
528,791,서울특별시 용산구 한강로3가,5358,1556,3063,654,8421,2210,37.52909229999999,126.9606764
529,792,서울특별시 용산구 한강로동,25101,14120,13660,6641,38761,20761,37.5290615,126.9694881
530,793,서울특별시 용산구 한남동,40299,32788,21623,19818,61922,52606,37.5311789,127.0062454
531,794,서울특별시 용산구 효창동,3199,7373,1670,4081,4869,11454,37.5417318,126.9613055
532,795,서울특별시 용산구 후암동,3657,8385,1372,5003,5029,13388,37.5498915,126.9814212
533,796,서울특별시 은평구 갈현1동,6174,4246,3972,2904,10146,7150,37.623527,126.9167796
534,797,서울특별시 은평구 갈현2동,632,1382,200,680,832,2062,37.6185555,126.9157518
535,798,서울특별시 은평구 갈현동,4973,10982,2059,7529,7032,18511,37.6220821,126.9137086
536,799,서울특별시 은평구 구산동,6206,14965,2081,9815,8287,24780,37.6117223,126.9103085
537,800,서울특별시 은평구 녹번동,8186,9841,3900,5331,12086,15172,37.6059975,126.9339654
538,801,서울특별시 은평구 대조동,22279,13655,13037,8226,35316,21881,37.6141112,126.9208904
539,802,서울특별시 은평구 불광1동,8781,11401,4895,6481,13676,17882,37.6103068,126.9319455
540,803,서울특별시 은평구 불광2동,13331,8517,7932,5216,21263,13733,37.6215274,126.9276956
541,804,서울특별시 은평구 불광동,14810,18797,10161,11010,24971,29807,37.6183087,126.9390451
542,805,서울특별시 은평구 수색동,4029,9068,2227,5697,6256,14765,37.5840042,126.8955434
543,806,서울특별시 은평구 신사1동,4950,6456,2846,3966,7796,10422,37.598002,126.9121697
544,807,서울특별시 은평구 신사2동,7571,7040,3238,3725,10809,10765,37.5918918,126.9124479
545,808,서울특별시 은평구 신사동,6692,11550,3490,7094,10182,18644,37.5953803,126.9075953
546,809,서울특별시 은평구 역촌동,16971,19935,8694,11779,25665,31714,37.6044517,126.9169535
547,810,서울특별시 은평구 응암1동,3638,3990,1597,2098,5235,6088,37.60064089999999,126.9267232
548,811,서울특별시 은평구 응암2동,1451,6240,715,4013,2166,10253,37.5945306,126.9231128
549,812,서울특별시 은평구 응암3동,819,2428,317,1285,1136,3713,37.5922528,126.9157525
550,813,서울특별시 은평구 응암동,23363,32957,13639,18715,37002,51672,37.5926646,126.9205206
551,814,서울특별시 은평구 증산동,5125,6115,2032,2881,7157,8996,37.5849961,126.907314
552,815,서울특별시 은평구 진관동,20269,25964,11161,16539,31430,42503,37.6413466,126.9421897
553,816,서울특별시 종로구 가회동,253,699,64,270,317,969,37.5800055,126.9846912
554,817,서울특별시 종로구 경운동,31,51,11,10,42,61,37.57452869999999,126.9866772
555,818,서울특별시 종로구 계동,31,424,3,201,34,625,37.5806885,126.9871195
556,819,서울특별시 종로구 관수동,55,54,40,28,95,82,37.5690222,126.9904296
557,820,서울특별시 종로구 관훈동,3778,1495,1714,680,5492,2175,37.5739965,126.9848994
558,821,서울특별시 종로구 교남동,3255,4848,1877,2749,5132,7597,37.5718391,126.9619706
559,822,서울특별시 종로구 교북동,806,341,347,118,1153,459,37.5714471,126.961324
560,823,서울특별시 종로구 구기동,0,22,0,0,0,22,37.6180692,126.9581885
561,824,서울특별시 종로구 명륜1가,108,702,47,516,155,1218,37.5881388,126.9979737
562,825,서울특별시 종로구 명륜2가,0,0,0,0,0,0,37.5845012,126.9990943
563,826,서울특별시 종로구 명륜3가,923,1425,366,1031,1289,2456,37.589259,126.9923661
564,827,서울특별시 종로구 명륜4가,7994,1420,3340,719,11334,2139,37.58215149999999,126.9997419
565,828,서울특별시 종로구 묘동,272,176,73,101,345,277,37.5722755,126.9917495
566,829,서울특별시 종로구 무악동,3831,5044,2108,2801,5939,7845,37.5773553,126.9586242
567,830,서울특별시 종로구 부암동,4866,9873,2253,6102,7119,15975,37.5962608,126.9676991
568,831,서울특별시 종로구 사직동,16765,7807,7856,4517,24621,12324,37.5761637,126.9688063
569,832,서울특별시 종로구 삼청동,2543,1560,855,687,3398,2247,37.5848379,126.9819133
570,833,서울특별시 종로구 세종로,13210,3662,5662,1643,18872,5305,37.5822874,126.9769233
571,834,서울특별시 종로구 숭인1동,11545,9806,7313,7401,18858,17207,37.5777283,127.0156602
572,835,서울특별시 종로구 숭인2동,287,599,147,528,434,1127,37.5748398,127.0199379
573,836,서울특별시 종로구 숭인동,1191,1907,682,1196,1873,3103,37.5747055,127.0186416
574,837,서울특별시 종로구 신문로1가,279,174,173,139,452,313,37.5700056,126.9738934
575,838,서울특별시 종로구 안국동,2807,1619,1239,754,4046,2373,37.5771212,126.983616
576,839,서울특별시 종로구 연건동,7198,2200,2658,1037,9856,3237,37.578917,126.9995883
577,840,서울특별시 종로구 예지동,52,21,21,5,73,26,37.569664,126.9983878
578,841,서울특별시 종로구 옥인동,99,731,42,423,141,1154,37.5841277,126.9617495
579,842,서울특별시 종로구 운니동,10,4,0,2,10,6,37.5763581,126.9880684
580,843,서울특별시 종로구 원남동,1797,1246,521,608,2318,1854,37.57554349999999,126.9974476
581,844,서울특별시 종로구 원서동,22,314,4,273,26,587,37.580603,126.9887674
582,845,서울특별시 종로구 이화동,15641,9552,8885,5338,24526,14890,37.5769232,127.0043003
583,846,서울특별시 종로구 인사동,20908,4677,13840,2643,34748,7320,37.5716555,126.9862326
584,847,서울특별시 종로구 인의동,279,301,111,93,390,394,37.57223130000001,126.9974345
585,848,서울특별시 종로구 재동,540,115,194,45,734,160,37.57840729999999,126.9851898
586,849,서울특별시 종로구 종로1.2.3.4가동,13572,4653,6588,2383,20160,7036,37.5706457,126.988968
587,850,서울특별시 종로구 종로1가,15262,4070,8089,2416,23351,6486,37.5701623,126.9802978
588,851,서울특별시 종로구 종로2가,904,570,663,316,1567,886,37.5701735,126.985657
589,852,서울특별시 종로구 종로3가,21820,5835,14084,3601,35904,9436,37.5703665,126.9919515
590,853,서울특별시 종로구 종로4가,8371,3137,4630,2273,13001,5410,37.5705927,126.9971121
591,854,서울특별시 종로구 종로5.6가동,1931,2788,932,1926,2863,4714,37.5719508,127.0050224
592,855,서울특별시 종로구 종로5가,7778,2594,4214,1713,11992,4307,37.5704682,127.0038437
593,856,서울특별시 종로구 종로6가,352,185,201,112,553,297,37.571853,127.0078329
594,857,서울특별시 종로구 창신1동,473,1018,321,519,794,1537,37.5706742,127.0163263
595,858,서울특별시 종로구 창신2동,169,497,82,408,251,905,37.5744237,127.0108268
596,859,서울특별시 종로구 창신3동,264,1606,133,1188,397,2794,37.5777563,127.0149653
597,860,서울특별시 종로구 창신동,12469,10849,8857,8905,21326,19754,37.5750914,127.0121575
598,861,서울특별시 종로구 청운동,31,187,8,96,39,283,37.58936620000001,126.9697192
599,862,서울특별시 종로구 청운효자동,3048,5261,874,2951,3922,8212,37.5840608,126.9705804
600,863,서울특별시 종로구 체부동,8835,2976,5071,1325,13906,4301,37.577354,126.9709019
601,864,서울특별시 종로구 통인동,48,91,29,52,77,143,37.5803981,126.9701593
602,865,서울특별시 종로구 평창동,6378,11164,2045,6460,8423,17624,37.6053351,126.9668582
603,866,서울특별시 종로구 혜화동,22222,11553,13228,7151,35450,18704,37.586755,127.0003554
604,867,서울특별시 종로구 홍지동,455,1385,74,565,529,1950,37.601247,126.9562041
605,868,서울특별시 종로구 홍파동,7,24,1,3,8,27,37.5709038,126.9639262
606,869,서울특별시 종로구 효제동,2773,1022,1414,597,4187,1619,37.5738196,127.0027668
607,870,서울특별시 중구 광희동,3041,2289,2237,1374,5278,3663,37.5644798,127.0052446
608,871,서울특별시 중구 남대문로2가,4337,1141,2423,820,6760,1961,37.5638735,126.9820656
609,872,서울특별시 중구 남대문로3가,5992,2764,3591,1525,9583,4289,37.5619687,126.9803334
610,873,서울특별시 중구 남대문로5가,6134,2892,3918,2147,10052,5039,37.5562032,126.9749646
611,874,서울특별시 중구 남창동,2838,1463,1805,982,4643,2445,37.5578822,126.9772626
612,875,서울특별시 중구 다동,2132,858,1291,525,3423,1383,37.5678759,126.9811398
613,876,서울특별시 중구 다산동,1498,2908,897,1656,2395,4564,37.554376,127.0084746
614,877,서울특별시 중구 동화동,96,731,70,386,166,1117,37.559973,127.018296
615,878,서울특별시 중구 만리동2가,600,1244,243,723,843,1967,37.5547643,126.964253
616,879,서울특별시 중구 명동,8083,4842,4931,2661,13014,7503,37.55998,126.9858296
617,880,서울특별시 중구 방산동,226,199,182,137,408,336,37.5688961,127.0028604
618,881,서울특별시 중구 봉래동2가,25079,18497,15586,9244,40665,27741,37.5564965,126.9710206
619,882,서울특별시 중구 서소문동,4596,1074,2524,738,7120,1812,37.5628953,126.97381
620,883,서울특별시 중구 소공동,6388,2223,3416,1281,9804,3504,37.5623685,126.9770254
621,884,서울특별시 중구 신당5동,3114,4353,1739,2889,4853,7242,37.565064,127.021826
622,885,서울특별시 중구 신당동,23526,16719,14076,11038,37602,27757,37.5615738,127.0194523
623,886,서울특별시 중구 쌍림동,2494,3464,1893,1946,4387,5410,37.5635752,127.0043943
624,887,서울특별시 중구 약수동,1419,3415,664,1626,2083,5041,37.554347,127.011001
625,888,서울특별시 중구 예장동,3397,458,220,44,3617,502,37.5551027,126.9896164
626,889,서울특별시 중구 을지로1가,1841,531,1113,372,2954,903,37.5659887,126.9807672
627,890,서울특별시 중구 을지로2가,5537,1906,3022,879,8559,2785,37.5658904,126.9850802
628,891,서울특별시 중구 을지로3가,3662,1214,2520,383,6182,1597,37.5661262,126.9916862
629,892,서울특별시 중구 을지로4가,1817,808,982,357,2799,1165,37.5664649,126.9978028
630,893,서울특별시 중구 을지로5가,487,295,258,98,745,393,37.5664267,127.0025169
631,894,서울특별시 중구 을지로6가,11454,5098,8133,3290,19587,8388,37.5675139,127.0065887
632,895,서울특별시 중구 을지로동,887,685,659,442,1546,1127,37.5667292,126.9913019
633,896,서울특별시 중구 의주로1가,3962,3212,1791,1598,5753,4810,37.564763,126.9681904
634,897,서울특별시 중구 장충동,5712,2516,1857,1288,7569,3804,37.5617581,127.0077164
635,898,서울특별시 중구 장충동1가,1029,726,418,456,1447,1182,37.5608027,127.0076024
636,899,서울특별시 중구 장충동2가,21,57,1,8,22,65,37.5553677,127.0021234
637,900,서울특별시 중구 저동1가,3480,2841,2113,1399,5593,4240,37.5642948,126.9879413
638,901,서울특별시 중구 정동,5012,4500,3420,1615,8432,6115,37.5665684,126.9728716
639,902,서울특별시 중구 중림동,5404,8335,3565,4808,8969,13143,37.55475819999999,126.9644988
640,903,서울특별시 중구 충무로1가,2055,809,1090,575,3145,1384,37.5609432,126.9825464
641,904,서울특별시 중구 충무로5가,1013,813,494,460,1507,1273,37.5633775,127.0003222
642,905,서울특별시 중구 태평로2가,2987,1312,1555,679,4542,1991,37.5630763,126.9765618
643,906,서울특별시 중구 필동,49,381,73,227,122,608,37.5600911,126.9955787
644,907,서울특별시 중구 필동1가,2353,864,1741,642,4094,1506,37.5609015,126.9924937
645,908,서울특별시 중구 필동2가,1278,406,955,200,2233,606,37.5598189,126.9946111
646,909,서울특별시 중구 황학동,928,855,524,584,1452,1439,37.5674517,127.0214099
647,910,서울특별시 중구 회현동,1075,3554,657,1182,1732,4736,37.5572302,126.9793303
648,911,서울특별시 중구 회현동2가,836,974,405,623,1241,1597,37.5589433,126.9829133
649,912,서울특별시 중구 흥인동,576,568,526,867,1102,1435,37.5674439,127.0167756
650,913,서울특별시 중랑구 망우3동,281,1357,131,840,412,2197,37.5927,127.0981797
651,914,서울특별시 중랑구 망우동,5613,13124,2503,8209,8116,21333,37.60002619999999,127.1068617
652,915,서울특별시 중랑구 망우본동,6397,6576,3187,3835,9584,10411,37.6012551,127.1065397
653,916,서울특별시 중랑구 면목2동,931,3021,438,1787,1369,4808,37.5897,127.0790427
654,917,서울특별시 중랑구 면목3.8동,1594,3035,563,1801,2157,4836,37.582979,127.088014
655,918,서울특별시 중랑구 면목4동,1371,2961,610,1905,1981,4866,37.574675,127.0855975
656,919,서울특별시 중랑구 면목5동,1033,2040,576,1365,1609,3405,37.5857565,127.0795427
657,920,서울특별시 중랑구 면목7동,668,3412,410,1946,1078,5358,37.5788965,127.0867362
658,921,서울특별시 중랑구 면목동,28033,30795,15086,18973,43119,49768,37.5811454,127.0883961
659,922,서울특별시 중랑구 면목본동,3778,6402,1886,3617,5664,10019,37.5873125,127.0874309
660,923,서울특별시 중랑구 묵1동,6781,8696,4437,5069,11218,13765,37.6123362,127.0784581
661,924,서울특별시 중랑구 묵2동,460,1014,310,616,770,1630,37.6113617,127.0787546
662,925,서울특별시 중랑구 묵동,3321,3730,1589,1780,4910,5510,37.6113617,127.0787546
663,926,서울특별시 중랑구 상봉1동,8464,10762,4116,7264,12580,18026,37.5998379,127.0871526
664,927,서울특별시 중랑구 상봉2동,7564,5680,4402,3179,11966,8859,37.5923388,127.0832922
665,928,서울특별시 중랑구 상봉동,4881,3822,2859,2018,7740,5840,37.5990737,127.0893441
666,929,서울특별시 중랑구 신내1동,3599,9811,1375,6179,4974,15990,37.6057824,127.0994562
667,930,서울특별시 중랑구 신내2동,7919,4454,4281,2748,12200,7202,37.6062543,127.0941517
668,931,서울특별시 중랑구 신내동,9331,15609,3380,9297,12711,24906,37.6103313,127.0960772
669,932,서울특별시 중랑구 중화1동,1326,2866,611,1778,1937,4644,37.6011436,127.0805692
670,933,서울특별시 중랑구 중화2동,1598,3478,891,2063,2489,5541,37.5949493,127.0748759
671,934,서울특별시 중랑구 중화동,15333,11241,9083,6035,24416,17276,37.5995064,127.0778661
